1,1,1,1,1,4,0,
0,0,0,6,1,1,0,
0,1,1,1,1,1,4,
0,1,4,0,1,1,1,
0,1,0,0,0,1,6,
0,1,1,1,0,0,0,
2,1,0,3,1,1,0,7